"No! Wait guys! Don't do this!" Your friends push you out of the bedroom, and lock the door behind you. In your own house! Well, at least you know where the key is to to get back in...wait...do you?

Open the Door
An Interactive Fiction by Dylan Vodzak
Release 1 / Serial number 141007 / Inform 7 build 6L38 (I6/v6.33 lib 6/12N) SD

Family Room
This is where you and your friends were hanging out earlier. A carpet is in the middle of the room. A painting is on the north wall. A dresser is in the northwest corner of the room, while an armchair is in the southwest corner. An urn is near the door to the office in the northeast. The office is to the east. Your room is to the south.

>Take key
Taken.

>unlock oak door
(with the brass key)
You unlock the oak door.

>s
(first opening the oak door)

Your Room

* * *

>look behind painting
Upon peering behind the painting, you find a safe. This must have been installed when you were at school.

>look under carpet
Sweet! A yellow key. You're lucky to have looked here. You put it in your pocket.

>e
Office
This is your dad's office. However he doesn't use it a whole lot. You and your friends were only in here for a bit, but then you all moved to the guest bedroom, which is east of the study. There is a brown desk in the southwest corner. A bookcase is in the northwest corner, and a shelf is against the east wall. The family room is to the west and the study is to the north.

>n
Darkness
It is pitch dark, and you can't see a thing.

>e
Bedroom
The guest bedroom is where your parents sleep. Your room is actually the main bedroom, but your parents were nice enough to switch. A king sized bed is in the northeast corner, while a TV is in the northwest corner. There is also a black desk on the south wall, and a yellow trunk in the southwest corner. The study is back to the west.

>unlock yellow trunk
(with the yellow key)
You unlock the yellow trunk.

>open yellow trunk
A bunch of toys from your childhood are in here. Out of the corner of your eye, you can see a red key near the bottom of the chest. You pocket the key, it may come in handy.

>i
You are carrying:
  a red key
  a yellow key

>w
Darkness
It is pitch dark, and you can't see a thing.

>s
Office
This is your dad's office. However he doesn't use it a whole lot. You and your friends were only in here for a bit, but then you all moved to the guest bedroom, which is east of the study. There is a brown desk in the southwest corner. A bookcase is in the northwest corner, and a shelf is against the east wall. The family room is to the west and the study is to the north.

>w
Family Room
This is where you and your friends were hanging out earlier. A carpet is in the middle of the room. A painting is on the north wall. A dresser is in the northwest corner of the room, while an armchair is in the southwest corner. An urn is near the door to the office in the northeast. The office is to the east. Your room is to the south.

>unlock dresser
What do you want to unlock the red dresser with?

>unlock dresser with red key
You unlock the red dresser.

>open dresser
DVD's and CD cases line the dresser drawers. In one of the drawers, you see a brown key. You pocket the brown key.

>e
Office
This is your dad's office. However he doesn't use it a whole lot. You and your friends were only in here for a bit, but then you all moved to the guest bedroom, which is east of the study. There is a brown desk in the southwest corner. A bookcase is in the northwest corner, and a shelf is against the east wall. The family room is to the west and the study is to the north.

>unlock brown desk with brown key
You unlock the brown desk.

>open brown desk
Opening the desk, you see the safe instructions that your dad put in here. This might come in handy.

>x safe instructions
You can't see any such thing.

>w
Family Room
This is where you and your friends were hanging out earlier. A carpet is in the middle of the room. A painting is on the north wall. A dresser is in the northwest corner of the room, while an armchair is in the southwest corner. An urn is near the door to the office in the northeast. The office is to the east. Your room is to the south.

>look behind painting
Upon peering behind the painting, you find a safe. This must have been installed when you were at school.

>x safe
A safe that is mounted on the north wall of the room. Your parents just installed it, so the only thing that should be in there is a flashlight that your dad was using to mount it. It appears to have a combination lock. What were your parents thinking when they decided to put this in here?

(HINT: When unlocking the safe, type: spin safe to {Entire Value Here}

For example: spin safe to 1234)

>i
You are carrying:
  Instructions
  a brown key
  a red key
  a yellow key

>spin safe to 1997
You hear a "Click" and the safe door swings open. You can see a flashlight.

>take flashlight
Taken.

>turn flashlight on
You click the flashlight on

>e
Office
This is your dad's office. However he doesn't use it a whole lot. You and your friends were only in here for a bit, but then you all moved to the guest bedroom, which is east of the study. There is a brown desk in the southwest corner. A bookcase is in the northwest corner, and a shelf is against the east wall. The family room is to the west and the study is to the north.

>n
Study
A hangout area for the house other then the family room. You remember that the lightbulb sputtered out while you and your friends were in there, making everyone retreat to your room. There is a grandfather clock in the the northwest corner of the room. A couch is resting against the north wall, and a potted ficus is in the southwest corner. A rug is sprawled across the floor. The guest bedroom is to the east, and the office is to the south.

You can see a brass key here.

>take brass key
Taken.

>x brass key
A key to your room that you put in the fake ficus for emergencies just like this.

>s
Office
This is your dad's office. However he doesn't use it a whole lot. You and your friends were only in here for a bit, but then you all moved to the guest bedroom, which is east of the study. There is a brown desk in the southwest corner. A bookcase is in the northwest corner, and a shelf is against the east wall. The family room is to the west and the study is to the north.

>e
You can't go that way.

>w
Family Room
This is where you and your friends were hanging out earlier. A carpet is in the middle of the room. A painting is on the north wall. A dresser is in the northwest corner of the room, while an armchair is in the southwest corner. An urn is near the door to the office in the northeast. The office is to the east. Your room is to the south.

>s
Unlocking the door, you quickly barge into your room, tackling your friends. You all get up and laugh about it for a while. They didn't realize you had a key in the house somewhere. You then tell them your adventure.

    *** The End ***

Would you like to RESTART, RESTORE a saved game, QUIT or UNDO the last command?

>unlock door with brass key
Please give one of the answers above.

Would you like to RESTART, RESTORE a saved game, QUIT or UNDO the last command?

>s
Please give one of the answers above.

Would you like to RESTART, RESTORE a saved game, QUIT or UNDO the last command?

>s
Please give one of the answers above.

Would you like to RESTART, RESTORE a saved game, QUIT or UNDO the last command?

* * *

>look under carpet
Sweet! A yellow key. You're lucky to have looked here. You put it in your pocket.

>i
You are carrying:
  a yellow key

* * *

>look under carpet
Sweet! A yellow key. You're lucky to have looked here. You put it in your pocket.

>take carpet
That's hardly portable.

>e
Office
This is your dad's office. However he doesn't use it a whole lot. You and your friends were only in here for a bit, because you convinced them that it wasn't a good idea to stay. There is a brown desk in the southwest corner. A bookcase is in the northwest corner, and a shelf is against the east wall. The family room is to the west and the study is to the north.

>n
Study

>e
Bedroom

>unlock trunk
(with the yellow key)
You unlock the yellow trunk.

>l
Bedroom

>take red key
You can't see any such thing.

>open trunk
You open the yellow trunk, revealing a red key.

>take red key
Taken.

>w
Study

>s
Office
This is your dad's office. However he doesn't use it a whole lot. You and your friends were only in here for a bit, because you convinced them that it wasn't a good idea to stay. There is a brown desk in the southwest corner. A bookcase is in the northwest corner, and a shelf is against the east wall. The family room is to the west and the study is to the north.

>w
Family Room
This is where my friends and I were hanging out earlier. A carpet is in the middle of the room. A safe is on the north wall. A dresser is in the northwest corner of the room, while an armchair is in the southwest corner. An ern is near the door to the office in the northeast. The office is to the east. Your room is to the south.

>unlock dresser
What do you want to unlock the red dresser with?

* * *

>unlock dresser with red key
You unlock the red dresser.

>open dresser
You open the red dresser, revealing a brown key.

>take brown key
Taken.

>e
Office
This is your dad's office. However he doesn't use it a whole lot. You and your friends were only in here for a bit, because you convinced them that it wasn't a good idea to stay. There is a brown desk in the southwest corner. A bookcase is in the northwest corner, and a shelf is against the east wall. The family room is to the west and the study is to the north.

>unlock desk with brown key
You unlock the brown desk.

>i
You are carrying:
  a brown key
  a red key
  a yellow key

>x yellow key
You see nothing special about the yellow key.

* * *

>e
Bedroom
The guest bedroom is where your parents sleep. Your room is actually the main bedroom, but your parents were nice enough to switch. A king sized bed is in the northeast corner, while a TV is in the northwest corner. There is also a black desk on the south wall, and a yellow trunk in the southwest corner. The study is back to the west.

>open trunk
It seems to be locked.

>unlock trunk
(with the yellow key)
You unlock the yellow trunk.

>open trunk
A bunch of toys from your childhood are in here. Out of the corner of your eye, you can see a red key near the bottom of the chest. You pocket the key, it may come in handy.

* * *

>unlock yellow trunk
(with the yellow key)
You unlock the yellow trunk.

>open trukn
You can't see any such thing.

>open trun
You can't see any such thing.

>open trunk
You open the yellow trunk, revealing a red key.

* * *

>take red key
Taken.

>e
You can't go that way.

>w
Darkness
It is pitch dark, and you can't see a thing.

* * *

>s
Office
This is your dad's office. However he doesn't use it a whole lot. You and your friends were only in here for a bit, but then you all moved to the guest bedroom, which is east of the study. There is a brown desk in the southwest corner. A bookcase is in the northwest corner, and a shelf is against the east wall. The family room is to the west and the study is to the north.

>w
Family Room
This is where my friends and I were hanging out earlier. A carpet is in the middle of the room. A safe is on the north wall. A dresser is in the northwest corner of the room, while an armchair is in the southwest corner. An ern is near the door to the office in the northeast. The office is to the east. Your room is to the south.

>unlock dresser with red key
You unlock the red dresser.

* * *

>take brown key
Taken.

>e
Office
This is your dad's office. However he doesn't use it a whole lot. You and your friends were only in here for a bit, but then you all moved to the guest bedroom, which is east of the study. There is a brown desk in the southwest corner. A bookcase is in the northwest corner, and a shelf is against the east wall. The family room is to the west and the study is to the north.

>unlock desk with brown key
You unlock the brown desk.

>open brown desk
Opening the desk, you see the safe instructions that your dad put in here. This might come in handy.

>i
You are carrying:
  an instructions
  a brown key
  a red key
  a yellow key

* * *

>spin safe to 1132
Click! and nothing else happens.

* * *

>x carpet
A carpet that has big yellow hibicus's on it. It doesn't seem very flat however. An air pocket of sorts slightly sticks out. You're surprised you even noticed it.

>lift carpet
That's not a verb I recognise.

>look under carpet
Sweet! A yellow key. You're lucky to have looked here. You put it in your pocket.

* * *

>i
You are carrying:
  a yellow key

>x painting
A relatively bland painting placed awkardly on the wall. It looks like its being pushed off of the wall slightly.

>look behind painting
Upon peering behind the painting, you find a safe. This must have been installed when you were at school.

>unlock safe with key
That doesn't seem to be something you can unlock.

>x safe
A safe that is mounted on the north wall of the room. Your parents just installed it, so the only thing that should be in there is a flashlight that your dad was using to mount it. It appears to have a combination lock. What were your parents thinking when they decided to put this in here?

(HINT: When unlocking the safe, type: spin dial to {Entire Value Here}

For example: spin dial to 1234)

>l
Family Room
This is where you and your friends were hanging out earlier. A carpet is in the middle of the room. A painting is on the north wall. A dresser is in the northwest corner of the room, while an armchair is in the southwest corner. An urn is near the door to the office in the northeast. The office is to the east. Your room is to the south.

>x dresser
A red dresser that your parents decided to put in the family room. Not a whole lot of Fung Shui going on with this.

>open dresser
DVD's and CD cases line the dresser drawers. In one of the drawers, you see a brown key. You pocket the brown key.

>i
You are carrying:
  a brown key
  a yellow key

>x dvds
You can't see any such thing.

>x dvd
You can't see any such thing.

>x cds
You can't see any such thing.

>xcd
That's not a verb I recognise.

>x cd
You can't see any such thing.

>x armchair
You can't see any such thing.

>x arm chair
You can't see any such thing.

>x urn
A fat urn with what appears to be Chinese art along the side of it. It doesn't seem to fit into the room at all. Upon further investigation, you discover that it is empty.

>take urn
That's hardly portable.

>l
Family Room
This is where you and your friends were hanging out earlier. A carpet is in the middle of the room. A painting is on the north wall. A dresser is in the northwest corner of the room, while an armchair is in the southwest corner. An urn is near the door to the office in the northeast. The office is to the east. Your room is to the south.

>x safe
A safe that is mounted on the north wall of the room. Your parents just installed it, so the only thing that should be in there is a flashlight that your dad was using to mount it. It appears to have a combination lock. What were your parents thinking when they decided to put this in here?

(HINT: When unlocking the safe, type: spin dial to {Entire Value Here}

For example: spin dial to 1234)

>e
Office
This is your dad's office. However he doesn't use it a whole lot. You and your friends were only in here for a bit, but then you all moved to the guest bedroom, which is east of the study. There is a brown desk in the southwest corner. A bookcase is in the northwest corner, and a shelf is against the east wall. The family room is to the west and the study is to the north.

>x desk
This is the office desk. It seems to stick out because of its brown color. There is nothing on top of the desk, however there is a locked drawer that stands out.

>i
You are carrying:
  a brown key
  a yellow key

* * *

>x carpet
A carpet that has big yellow hibicus's on it. It doesn't seem very flat however. An air pocket of sorts slightly sticks out. You're surprised you even noticed it.

>take carpet
That's hardly portable.

>look under carpet
Sweet! A yellow key. You're lucky to have looked here. You put it in your pocket.

* * *

>i
You are carrying:
  a yellow key

>x yellow key
Its a yellow key for the trunk.

* * *

>x carpet
A carpet that has big yellow hibicus's on it. It doesn't seem very flat however. An air pocket of sorts slightly sticks out. You're surprised you even noticed it.

>look under carpet
This might come in handy. I guess it wasn't an air-pocket in the carpet after all.

* * *

>s
(first opening the oak door)
It seems to be locked.

>look under carper
You can't see any such thing.

>look under carpet
Sweet! A yellow key. You're lucky to have looked here. You put it in your pocket.

>take yellow key
You already have that.

>e
Office
This is your dad's office. However he doesn't use it a whole lot. You and your friends were only in here for a bit, but then you all moved to the guest bedroom, which is east of the study. There is a brown desk in the southwest corner. A bookcase is in the northwest corner, and a shelf is against the east wall. The family room is to the west and the study is to the north.

* * *

>e
Bedroom
The guest bedroom is where your parents sleep. Your room is actually the main bedroom, but your parents were nice enough to switch. A king sized bed is in the northeast corner, while a TV is in the northwest corner. There is also a black desk on the south wall, and a yellow trunk in the southwest corner. The study is back to the west.

>unlock trunk with yellow key
You unlock the yellow trunk.

>open trunk
A bunch of toys from your childhood are in here. Out of the corner of your eye, you can see a red key near the bottom of the chest. You pocket the key, it may come in handy.

>w
Darkness
It is pitch dark, and you can't see a thing.

* * *

>w
Family Room
This is where you and your friends were hanging out earlier. A carpet is in the middle of the room. A painting is on the north wall. A dresser is in the northwest corner of the room, while an armchair is in the southwest corner. An urn is near the door to the office in the northeast. The office is to the east. Your room is to the south.

>unlock dresser with red key
You unlock the red dresser.

>open red dresser
DVD's and CD cases line the dresser drawers. In one of the drawers, you see a brown key. You pocket the brown key.

>e
Office
This is your dad's office. However he doesn't use it a whole lot. You and your friends were only in here for a bit, but then you all moved to the guest bedroom, which is east of the study. There is a brown desk in the southwest corner. A bookcase is in the northwest corner, and a shelf is against the east wall. The family room is to the west and the study is to the north.

* * *

>unlock desk with brown key
You unlock the brown desk.

>open desk
Opening the desk, you see instructions to the safe that your dad put in here. This might come in handy.

>x safe instructions
You can't see any such thing.

>x instructions
A 10 paged pamphlet on how the safe should be properly set up and mantled into the wall. There is a note scribbled in black sharpie on the corner of one of the pages, "1997".

>w
Family Room
This is where you and your friends were hanging out earlier. A carpet is in the middle of the room. A painting is on the north wall. A dresser is in the northwest corner of the room, while an armchair is in the southwest corner. An urn is near the door to the office in the northeast. The office is to the east. Your room is to the south.

* * *

>look behind painting
Upon peering behind the painting, you find a safe. This must have been installed when you were at school.

>x safe
A safe that is mounted on the north wall of the room. Your parents just installed it, so the only thing that should be in there is a flashlight that your dad was using to mount it. It appears to have a combination lock. What were your parents thinking when they decided to put this in here?

(HINT: When unlocking the safe, type: spin dial to {Entire Value Here}

For example: spin dial to 1234)

>spin dial to 1997
You hear a "Click" and the safe door swings open. You can see a flashlight.

>take flashlight
Taken.

>e
Office
This is your dad's office. However he doesn't use it a whole lot. You and your friends were only in here for a bit, but then you all moved to the guest bedroom, which is east of the study. There is a brown desk in the southwest corner. A bookcase is in the northwest corner, and a shelf is against the east wall. The family room is to the west and the study is to the north.

* * *

>n
Darkness
It is pitch dark, and you can't see a thing.

>turn flashlight on
You click the flashlight on
Study
A hangout area for the house other then the family room. You remember that the lightbulb sputtered out while you and your friends were in there, making everyone retreat to your room. There is a grandfather clock in the the northwest corner of the room. A couch is resting against the north wall, and a potted ficus is in the southwest corner. A rug is sprawled across the floor. The guest bedroom is to the east, and the office is to the south.

>take brass key
Taken.

>s
Office
This is your dad's office. However he doesn't use it a whole lot. You and your friends were only in here for a bit, but then you all moved to the guest bedroom, which is east of the study. There is a brown desk in the southwest corner. A bookcase is in the northwest corner, and a shelf is against the east wall. The family room is to the west and the study is to the north.

* * *

>w
Family Room
This is where you and your friends were hanging out earlier. A carpet is in the middle of the room. A painting is on the north wall. A dresser is in the northwest corner of the room, while an armchair is in the southwest corner. An urn is near the door to the office in the northeast. The office is to the east. Your room is to the south.

>s
(first opening the oak door)
It seems to be locked.

>unlock door with brass key
Unlocking the door, you quickly barge into your room, tackling your friends. You all get up and laugh about it for a while. They didn't realize you had a key in the house somewhere. You then tell them your adventure.

    *** The End ***

Would you like to RESTART, RESTORE a saved game, QUIT or UNDO the last command?

* * *

>s
(first opening the oak door)
It seems to be locked.

>unlock door
What do you want to unlock the oak door with?

>l
Family Room
This is where my friends and I were hanging out earlier. A carpet is in the middle of the room. A painting is on the north wall. A dresser is in the northwest corner of the room, while an armchair is in the southwest corner. A fat ern is near the door to the office in the northeast. The office is to the east. Your room is to the south.

>take key
You can't see any such thing.

* * *

>s
(first opening the oak door)
It seems to be locked.

>x painting
You can't see any such thing.

* * *

>open dresser
It seems to be locked.

>take dresser
That's too heavy.

>lock dresser
(with the red dresser)
(first taking the red dresser)
That's too heavy.

>open dresser
It seems to be locked.

* * *

>x painting
A relatively bland painting. It looks like its being pushed off of the wall slightly. What's behind it?

>look behind painting
Upon peering behind the painting, you find a safe. This must have been installed when you were at school.

* * *

>e
Office
This is your dad's office. However he doesn't use it a whole lot. You and your friends were only in here for a bit, but then you all moved to the guest bedroom, which is east of the study. There is a brown desk in the southwest corner. A bookcase is in the northwest corner, and a shelf is against the east wall. The family room is to the west and the study is to the north.

* * *

>e
Bedroom
The guest bedroom is where your parents sleep. Your room is actually the main bedroom, but your parents were nice enough to switch. A king sized bed is in the northeast corner, while a TV is in the northwest corner. There is also a black desk on the south wall, and a yellow trunk in the southwest corner. The study is back to the west.

>w
Study

>s
Office

* * *

>e
Bedroom
The guest bedroom is where your parents sleep. Your room is actually the main bedroom, but your parents were nice enough to switch. A king sized bed is in the northeast corner, while a TV is in the northwest corner. There is also a black desk on the south wall, and a yellow trunk in the southwest corner. The study is back to the west.

>s
You can't go that way.

>w
Darkness
It is pitch dark, and you can't see a thing.

* * *

>x desk
This is the office desk. It seems to stick out because of its brown color. There is nothing on top of the desk, however there is a locked drawer that stands out.

>open desk
It seems to be locked.

>unlock desk
(with the brown desk)
(first taking the brown desk)
That's hardly portable.

>unlock desk with key
You can't see any such thing.

* * *

>x urn
A fat ern with what appears to be Chinese art along the side of it. It doesn't seem to fit into the room at all. Upon further investigation, you discover that it is empty.

>x painting
A relatively bland painting. It looks like its being pushed off of the wall slightly. What's behind it?

>open painting
It isn't something you can open.

>behind painting
That's not a verb I recognise.

>kill myself
Violence isn't the answer to this one.

>look behind painting
Upon peering behind the painting, you find a safe. This must have been installed when you were at school.

>open safe
It isn't something you can open.

>unlock safe
What do you want to unlock the Safe with?

>unlock safe with fist
You can't see any such thing.

>l
Family Room
This is where you and your friends were hanging out earlier. A carpet is in the middle of the room. A painting is on the north wall. A dresser is in the northwest corner of the room, while an armchair is in the southwest corner. An urn is near the door to the office in the northeast. The office is to the east. Your room is to the south.

* * *

>x safe
A safe that is mounted on the north wall of the room. Your parents just installed it, so the only thing that should be in there is a flashlight that your dad was using to mount it. It appears to have a combination lock. What were your parents thinking when they decided to put this in here?

(HINT: When unlocking the safe, type: spin dial to {Entire Value Here}

For example: spin dial to 1234)

>2331314
That's not a verb I recognise.

>unlock safe :spin dial to {1234}
I didn't understand that sentence.

>spin dial {1234}
I didn't understand that sentence.

>x combination lock
You can't see any such thing.

>unlock safe
What do you want to unlock the Safe with?

>spin dial to {1234}
I didn't understand that number.

>spin dial 1234
I didn't understand that sentence.

>spin dial to 1234
You hear a "Click", but nothing else happens.

>fuck you
That's not a verb I recognise.

>open safe
It isn't something you can open.

>x safe
A safe that is mounted on the north wall of the room. Your parents just installed it, so the only thing that should be in there is a flashlight that your dad was using to mount it. It appears to have a combination lock. What were your parents thinking when they decided to put this in here?

(HINT: When unlocking the safe, type: spin dial to {Entire Value Here}

For example: spin dial to 1234)

* * *

>l
Family Room
This is where you and your friends were hanging out earlier. A carpet is in the middle of the room. A painting is on the north wall. A dresser is in the northwest corner of the room, while an armchair is in the southwest corner. An urn is near the door to the office in the northeast. The office is to the east. Your room is to the south.

>x carpet
A carpet that has big yellow hibicus's on it. It doesn't seem very flat however. An air pocket of sorts slightly sticks out. You're surprised you even noticed it.

>x air pocket
You can't see any such thing.

>x air pocket
You can't see any such thing.

>x dresser
A red dresser that your parents decided to put in the family room. Not a whole lot of Fung Shui going on with this.

>e
Office
This is your dad's office. However he doesn't use it a whole lot. You and your friends were only in here for a bit, but then you all moved to the guest bedroom, which is east of the study. There is a brown desk in the southwest corner. A bookcase is in the northwest corner, and a shelf is against the east wall. The family room is to the west and the study is to the north.

>cancer
That's not a verb I recognise.

>x brown desk
This is the office desk. It seems to stick out because of its brown color. There is nothing on top of the desk, however there is a locked drawer that stands out.

>x locked drawer
You can't see any such thing.

>x drawer
You can't see any such thing.

>x bookcase
A bookcase filled with a bunch of cool science related books. None of them particularly stand out.

>x shelf
A shelf filled with knick-knacks that don't seem to have any purpose. It would be wise not to touch them. None of them particularly stand out.

>take all
There are none at all available!

>get all
There are none at all available!

>l
Office
This is your dad's office. However he doesn't use it a whole lot. You and your friends were only in here for a bit, but then you all moved to the guest bedroom, which is east of the study. There is a brown desk in the southwest corner. A bookcase is in the northwest corner, and a shelf is against the east wall. The family room is to the west and the study is to the north.

>e
You can't go that way.

* * *

>w
Family Room
This is where you and your friends were hanging out earlier. A carpet is in the middle of the room. A painting is on the north wall. A dresser is in the northwest corner of the room, while an armchair is in the southwest corner. An urn is near the door to the office in the northeast. The office is to the east. Your room is to the south.

>e
Office
This is your dad's office. However he doesn't use it a whole lot. You and your friends were only in here for a bit, but then you all moved to the guest bedroom, which is east of the study. There is a brown desk in the southwest corner. A bookcase is in the northwest corner, and a shelf is against the east wall. The family room is to the west and the study is to the north.

>i
You are carrying nothing.

>n
Darkness
It is pitch dark, and you can't see a thing.

>fuck yoi
That's not a verb I recognise.

>fuck you
That's not a verb I recognise.

>s
Office
This is your dad's office. However he doesn't use it a whole lot. You and your friends were only in here for a bit, but then you all moved to the guest bedroom, which is east of the study. There is a brown desk in the southwest corner. A bookcase is in the northwest corner, and a shelf is against the east wall. The family room is to the west and the study is to the north.

* * *

>s
(first opening the oak door)
It seems to be locked.

>n
You can't go that way.

>e
Office
This is your dad's office. However he doesn't use it a whole lot. You and your friends were only in here for a bit, but then you all moved to the guest bedroom, which is east of the study. There is a brown desk in the southwest corner. A bookcase is in the northwest corner, and a shelf is against the east wall. The family room is to the west and the study is to the north.

>w
Family Room
This is where you and your friends were hanging out earlier. A carpet is in the middle of the room. A painting is on the north wall. A dresser is in the northwest corner of the room, while an armchair is in the southwest corner. An urn is near the door to the office in the northeast. The office is to the east. Your room is to the south.

>x carpet
A carpet that has big yellow hibicus's on it. It doesn't seem very flat however. An air pocket of sorts slightly sticks out. You're surprised you even noticed it.

* * *

>lift carpet
That's not a verb I recognise.

>reach under carpet
That's not a verb I recognise.

>shit under carpet
That's not a verb I recognise.

>look under carpet
Sweet! A yellow key. You're lucky to have looked here. You put it in your pocket.

* * *

>x yellow key
Its a yellow key for the trunk.

>who
That's not a verb I recognise.

>wow
That's not a verb I recognise.

>l
Family Room
This is where you and your friends were hanging out earlier. A carpet is in the middle of the room. A painting is on the north wall. A dresser is in the northwest corner of the room, while an armchair is in the southwest corner. An urn is near the door to the office in the northeast. The office is to the east. Your room is to the south.

>northeast
You can't go that way.

>break through wall
You can't see any such thing.

>s
(first opening the oak door)
It seems to be locked.

>open oak door with yellow key
That doesn't seem to fit the lock.

>fuck you
That's not a verb I recognise.

>s
(first opening the oak door)
It seems to be locked.

>e
Office
This is your dad's office. However he doesn't use it a whole lot. You and your friends were only in here for a bit, but then you all moved to the guest bedroom, which is east of the study. There is a brown desk in the southwest corner. A bookcase is in the northwest corner, and a shelf is against the east wall. The family room is to the west and the study is to the north.

>open drawer with yellow key
You can't see any such thing.

>fuck you
That's not a verb I recognise.

>n
Darkness
It is pitch dark, and you can't see a thing.

>use yellow key to trun on light
That's not a verb I recognise.

>please
That's not a verb I recognise.

>please
That's not a verb I recognise.

>e
Bedroom
The guest bedroom is where your parents sleep. Your room is actually the main bedroom, but your parents were nice enough to switch. A king sized bed is in the northeast corner, while a TV is in the northwest corner. There is also a black desk on the south wall, and a yellow trunk in the southwest corner. The study is back to the west.

>open yellow trunk with the yellow key
You unlock the yellow trunk.

>open yellow trunk
A bunch of toys from your childhood are in here. Out of the corner of your eye, you can see a red key near the bottom of the chest. You pocket the key, it may come in handy.

* * *

>i
You are carrying:
  a red key
  a yellow key

>take toys
You can't see any such thing.

>fuck toys
That's not a verb I recognise.

>the fluffy ones feel great
That's not a verb I recognise.

>l
Bedroom
The guest bedroom is where your parents sleep. Your room is actually the main bedroom, but your parents were nice enough to switch. A king sized bed is in the northeast corner, while a TV is in the northwest corner. There is also a black desk on the south wall, and a yellow trunk in the southwest corner. The study is back to the west.

>x bed
A king sized bed that seems really comfortable.

>x TV
A large flatscreen TV that seems to make this room a little cozier. You and your friends were watching it earlier, but it is turned off now.

>x  black desk
A regular desk that your mom never uses. It doesn't even seem like there is anything on it.

>w
Darkness
It is pitch dark, and you can't see a thing.

>ee
That's not a verb I recognise.

>s
Office
This is your dad's office. However he doesn't use it a whole lot. You and your friends were only in here for a bit, but then you all moved to the guest bedroom, which is east of the study. There is a brown desk in the southwest corner. A bookcase is in the northwest corner, and a shelf is against the east wall. The family room is to the west and the study is to the north.

* * *

>w
Family Room
This is where you and your friends were hanging out earlier. A carpet is in the middle of the room. A painting is on the north wall. A dresser is in the northwest corner of the room, while an armchair is in the southwest corner. An urn is near the door to the office in the northeast. The office is to the east. Your room is to the south.

>open oak door with red dick
You can't see any such thing.

>s
(first opening the oak door)
It seems to be locked.

>look behind painintg
You can't see any such thing.

>look behind painting
Upon peering behind the painting, you find a safe. This must have been installed when you were at school.

>open safe with red key
That doesn't seem to be something you can unlock.

>s
(first opening the oak door)
It seems to be locked.

>l
Family Room
This is where you and your friends were hanging out earlier. A carpet is in the middle of the room. A painting is on the north wall. A dresser is in the northwest corner of the room, while an armchair is in the southwest corner. An urn is near the door to the office in the northeast. The office is to the east. Your room is to the south.

>e
Office
This is your dad's office. However he doesn't use it a whole lot. You and your friends were only in here for a bit, but then you all moved to the guest bedroom, which is east of the study. There is a brown desk in the southwest corner. A bookcase is in the northwest corner, and a shelf is against the east wall. The family room is to the west and the study is to the north.

>x drawer
You can't see any such thing.

>i
You are carrying:
  a red key
  a yellow key

>x red key
Its a red key for the dresser.

>w
Family Room
This is where you and your friends were hanging out earlier. A carpet is in the middle of the room. A painting is on the north wall. A dresser is in the northwest corner of the room, while an armchair is in the southwest corner. An urn is near the door to the office in the northeast. The office is to the east. Your room is to the south.

* * *

>e
Office
This is your dad's office. However he doesn't use it a whole lot. You and your friends were only in here for a bit, but then you all moved to the guest bedroom, which is east of the study. There is a brown desk in the southwest corner. A bookcase is in the northwest corner, and a shelf is against the east wall. The family room is to the west and the study is to the north.

>e
You can't go that way.

>s
You can't go that way.

>n
Darkness
It is pitch dark, and you can't see a thing.

* * *

>s
You can't go that way.

>e
You can't go that way.

>n
You can't go that way.

>w
Darkness
It is pitch dark, and you can't see a thing.

>e
Bedroom
The guest bedroom is where your parents sleep. Your room is actually the main bedroom, but your parents were nice enough to switch. A king sized bed is in the northeast corner, while a TV is in the northwest corner. There is also a black desk on the south wall, and a yellow trunk in the southwest corner. The study is back to the west.

>w
Darkness
It is pitch dark, and you can't see a thing.

* * *

>w
Family Room
This is where you and your friends were hanging out earlier. A carpet is in the middle of the room. A painting is on the north wall. A dresser is in the northwest corner of the room, while an armchair is in the southwest corner. An urn is near the door to the office in the northeast. The office is to the east. Your room is to the south.

>open dresser with red key
You unlock the red dresser.

>suck a dick
That's not a verb I recognise.

>x dresser
A red dresser that your parents decided to put in the family room. Not a whole lot of Fung Shui going on with this.

* * *

>open dresser
DVD's and CD cases line the dresser drawers. In one of the drawers, you see a brown key. You pocket the brown key.

>take brown key
You already have that.

>fuck you
That's not a verb I recognise.

* * *

>s
(first opening the oak door)
It seems to be locked.

>open oak door with oak dick
I only understood you as far as wanting to open the oak door with the oak door.

I beg your pardon?

I beg your pardon?

>x brown key
Its a brown key for the desk.

>i
You are carrying:
  a brown key
  a red key
  a yellow key

>s
(first opening the oak door)
It seems to be locked.

* * *

>e
Office
This is your dad's office. However he doesn't use it a whole lot. You and your friends were only in here for a bit, but then you all moved to the guest bedroom, which is east of the study. There is a brown desk in the southwest corner. A bookcase is in the northwest corner, and a shelf is against the east wall. The family room is to the west and the study is to the north.

>open desk with brown key
You unlock the brown desk.

>open desk
Opening the desk, you see instructions to the safe that your dad put in here. This might come in handy.

>x instructions
A 10 paged pamphlet on how the safe should be properly set up and mantled into the wall. There is a note scribbled in black sharpie on the corner of one of the pages, "1997".

* * *

>w
Family Room
This is where you and your friends were hanging out earlier. A carpet is in the middle of the room. A painting is on the north wall. A dresser is in the northwest corner of the room, while an armchair is in the southwest corner. An urn is near the door to the office in the northeast. The office is to the east. Your room is to the south.

>x safe
A safe that is mounted on the north wall of the room. Your parents just installed it, so the only thing that should be in there is a flashlight that your dad was using to mount it. It appears to have a combination lock. What were your parents thinking when they decided to put this in here?

(HINT: When unlocking the safe, type: spin dial to {Entire Value Here}

For example: spin dial to 1234)

>spin dial 19976]
I didn't understand that sentence.

>spind tial 1997
That's not a verb I recognise.

>spin dial 1997
I didn't understand that sentence.

>spin dial to 1997
You hear a "Click" and the safe door swings open. You can see a flashlight.

* * *

>take flashlight
Taken.

>turn on flashlight
You click the flashlight on

>turn off flashlight
You click the flashlight off.

>save battery
I only understood you as far as wanting to save.

>s
(first opening the oak door)
It seems to be locked.

>open door
It seems to be locked.

>w
You can't go that way.

>e
Office
This is your dad's office. However he doesn't use it a whole lot. You and your friends were only in here for a bit, but then you all moved to the guest bedroom, which is east of the study. There is a brown desk in the southwest corner. A bookcase is in the northwest corner, and a shelf is against the east wall. The family room is to the west and the study is to the north.

* * *

>n
Darkness
It is pitch dark, and you can't see a thing.

>turn on flashlight
You click the flashlight on
Study
A hangout area for the house other then the family room. You remember that the lightbulb sputtered out while you and your friends were in there, making everyone retreat to your room. There is a grandfather clock in the the northwest corner of the room. A couch is resting against the north wall, and a potted ficus is in the southwest corner. A rug is sprawled across the floor. The guest bedroom is to the east, and the office is to the south.

>x grandfather clock
A big grandfather clock that your parents have had forever. Upon checking the time, you discover that a lot of time has passed since your friends arrived.

>x couch
A big couch that you often take naps on. Nothing seems really important about it, other than the fact that its really comfy.

>x rug
A rug smaller than the one in the family room. Nothing seems to special about it, other than the interesting designs.

>x potted fiscus
You can't see any such thing.

>x potted ficus
You can't see any such thing.

>x ficus
A fake plant that seems to be just for decoration. But on further inspection you see a brass key near the base of the plant...

>i
You are carrying:
  a flashlight (providing light)
  Instructions
  a brown key
  a red key
  a yellow key

>take brass key
Taken.

>w
You can't go that way.

>e
Bedroom
The guest bedroom is where your parents sleep. Your room is actually the main bedroom, but your parents were nice enough to switch. A king sized bed is in the northeast corner, while a TV is in the northwest corner. There is also a black desk on the south wall, and a yellow trunk in the southwest corner. The study is back to the west.

>n
You can't go that way.

>w
Study
A hangout area for the house other then the family room. You remember that the lightbulb sputtered out while you and your friends were in there, making everyone retreat to your room. There is a grandfather clock in the the northwest corner of the room. A couch is resting against the north wall, and a potted ficus is in the southwest corner. A rug is sprawled across the floor. The guest bedroom is to the east, and the office is to the south.

>e
Bedroom
The guest bedroom is where your parents sleep. Your room is actually the main bedroom, but your parents were nice enough to switch. A king sized bed is in the northeast corner, while a TV is in the northwest corner. There is also a black desk on the south wall, and a yellow trunk in the southwest corner. The study is back to the west.

>w
Study
A hangout area for the house other then the family room. You remember that the lightbulb sputtered out while you and your friends were in there, making everyone retreat to your room. There is a grandfather clock in the the northwest corner of the room. A couch is resting against the north wall, and a potted ficus is in the southwest corner. A rug is sprawled across the floor. The guest bedroom is to the east, and the office is to the south.

>s
Office
This is your dad's office. However he doesn't use it a whole lot. You and your friends were only in here for a bit, but then you all moved to the guest bedroom, which is east of the study. There is a brown desk in the southwest corner. A bookcase is in the northwest corner, and a shelf is against the east wall. The family room is to the west and the study is to the north.

* * *

>s
(first opening the oak door)
It seems to be locked.

>open oak door with brass key
Unlocking the door, you quickly barge into your room, tackling your friends. You all get up and laugh about it for a while. They didn't realize you had a key in the house somewhere. You then tell them your adventure.

    *** The End ***

Would you like to RESTART, RESTORE a saved game, QUIT or UNDO the last command?

>fuck you
Please give one of the answers above.

Would you like to RESTART, RESTORE a saved game, QUIT or UNDO the last command?

>mother fucker
Please give one of the answers above.

Would you like to RESTART, RESTORE a saved game, QUIT or UNDO the last command?

>that was hard
Please give one of the answers above.

Would you like to RESTART, RESTORE a saved game, QUIT or UNDO the last command?

Please give one of the answers above.

Would you like to RESTART, RESTORE a saved game, QUIT or UNDO the last command?

Please give one of the answers above.

Would you like to RESTART, RESTORE a saved game, QUIT or UNDO the last command?

* * *

>spin safe to 3939
You hear a "Click", but nothing else happens.

>spin safe to 18385
You hear a "Click", but nothing else happens.

>spin safe to 1997
You hear a, "Click" and the safe door swings open. You can see a flashlight.

>take flashlight
Taken.

* * *

>x safe
A safe that is mounted on the north wall of the room. Your parents just installed it, so the only thing that should be in there is a flashlight that your dad was using to mount it. It appears to have a combination lock. What were your parents thinking when they decided to put this in here?

(HINT: When unlocking the safe, type: spin safe to {Entire value here}

For example: spin safe to 1234)

>unlock safe
What do you want to unlock the Safe with?

>key
You can't see any such thing.

>unlock key
You can't see any such thing.

>spin
What do you want to spin?

>spin safe
I didn't understand that sentence.

>spin safe to 1997
You hear a, "Click" and the safe door swings open. You can see a flashlight.

* * *

>take flashlight
Taken.

>i
You are carrying:
  a flashlight

* * *

>x safe
A safe that is mounted on the north wall of the room. Your parents just installed it, so the only thing that should be in there is a flashlight that your dad was using to mount it. It appears to have a combination lock. What were your parents thinking when they decided to put this in here?

(HINT: When unlocking the safe, type: spin safe to {Entire value here}

For example: spin safe to 1234)

>spin safe to 1234
You hear a "Click", but nothing else happens.

* * *

>x dresser
A red dresser that your parents decided to put in the family room. Not a whole lot of Fung Shui going on with this.

>look under carpet
Sweet! A yellow key. You're lucky to have looked here. You put it in your pocket.

>x yellow key
Its a yellow key.

>l
Family Room
This is where you and your friends were hanging out earlier. A carpet is in the middle of the room. A painting is on the north wall. A dresser is in the northwest corner of the room, while an armchair is in the southwest corner. An urn is near the door to the office in the northeast. The office is to the east. Your room is to the south.

* * *

>e
Bedroom
The guest bedroom is where your parents sleep. Your room is actually the main bedroom, but your parents were nice enough to switch. A king sized bed is in the northeast corner, while a TV is in the northwest corner. There is also a black desk on the south wall, and a yellow trunk in the southwest corner. The study is back to the west.

>i
You are carrying:
  a yellow key

>open trunk
It seems to be locked.